11111111111111111111111111111111111
1E0000000C0000100000000000000000C11
100000000000C0100000000000000000011
100000000C0000000000000000000000C11
100000000000C0100000000000000000P11
11111111111111111111111111111111111