1111111111111111111111111111111111
1E0000000000000000100C000000010001
100000000000000C001000000000010001
1000010000100000001000100000010001
1000010000100010001000100000010001
1000010000100010001000100000010001
100000000C0000100000000000000000C1
100000000000C010000000000000000001
100000000C0000100000000000000000C1
100000000000C0100000000000000000P1
1111111111111111111111111111111111